X X S X E X X X X 
X X             X 
X     X X X   X X 
X   X X   X   X X 
X               X 
X X X X X X X X X 
